For Honor: Status de campeo + loot
Tenha acesso a um LCC Sanctus gratuito e muito mais
Fallout 76: Pacote de Sobrevivncia #1
Call of Duty: Pacote Escola de Voo
RuneScape: Inscrio + Animal de Estimao Abbora Prime
Madden NFL 22: Pacote Mais Temido do Prime
League of Legends: J disponvel - 3 Fragmento de Skin
Legends of Runeterra: Curinga pico Gratuito
Last Day on Earth: 1.000 Tampinhas
Epic Seven: 1x Tera-Phantasma, 6x Giga-Phantasmas e 20x Folhas da Vida
Genshin Impact: Pacote Prime Gaming #5
New World: Pacote Pirata #2
Paladins: Visual Suserano do Khan
Angry Birds Friends: Power-ups
SMITE: Visual Krang do Xing Tian
World of Warships: Acessrios de arco alemo e Pacote Cruzador de Emden Premium
Blade & Soul: Pacote de estilo lendrio
Warframe: Pacote Verv Furis
War of the Visions: Final Fantasy Brave Exvius: Vale de Evocao de Seleo de Unidade UR
Apex Legends: Pacote de royalties eltricos
Far Cry 6: Coleo Vaqueiro
Free Fire: Kapella (Personagem)
House Flip: Decorao de Halloween
Mobile Legends: Bang Bang: Ba Amazon Prime + Cartes de Teste de Heri e Skin
Fall Guys: Pacote Mastodonte Feliz
VALORANT: Spray Apenas Negcios
Dauntless: Pacote Foice Corrente Arcslayer
World of Tanks: Alta Tenso
World of Warships: Legends: Impulso de outono
Brawlhalla: Pacote Shogun
Guild Wars 2: Pacote de Kit de Tintura
Red Dead Online: Receba uma recompensa por 40 Capitale e uma oferta de 50% de desconto na pistola Mauser
Word Farm Adventure: Estilo de Bloco Madeira Azul
Sea of Thieves: Pacote de Pistola Cronch
Lineage II Aden: Pacote Boost
Rainbow Six Siege: Pacote de Operador de FrAgMenT
Call of Duty: Mobile: Pacote HBrA3
Destiny 2: Drop de Pacote Extico Cavalo Negro
House Flip: Passe Premium do Prime
